이번 6모 어땠어	?
나랑 비슷하네	ㅠ
지금 6모 외우고 있음	ㅋㅋ
수학 중간에 몇등급이었어	?
수학 1컷이 73이였음	ㅠㅠ
내일 방학해요 ^^	ㅠㅠ
2등급이 43등 까지 였음	ㅠㅠ
왤케 잘봤냐	ㅠㅠ
우리는 1등이1.25임	ㅋㅋ
다시 보니까 2.34임	ㅋㅋ
zzz	ㅋㅋㅋ
뜨개질 처럼	ㅋㅋ
아마도	...
이런거	....
톡게시판 '투표': 반티	.
쌤 사진은 초상권이니까 비슷한인믈로 대체	.
내가보낸거아님	ㅜㅜ
사진	..
이거뭐냐	..
그...	..
괜찮은 영상이니 한번씩 보길바람	.
시험에 안나온답니다	!!
사진	ㅋㅋㅋㅋ
헉 은찬이 DNA 끊어졌다	ㅠㅠㅠㅠㅠㅠㅠㅠㅠㅠㅠㅠㅠㅠㅠㅠ
영준아 뒤에 숫자 뭐야?	.
보냈어요	ㅋㅋㅋㅋㅋㅋ
사진	💋💋💋💋💋
진짜 왜그러는 거에요	.
주세여	🥵
안들어가져요	ㅠ
아니이건 너무 엽산데	ㅋㅋㅋㅋㅋㅋㅋ
민규도	?
지학실 아님 화학실로 가면 있음	ㅋㅋㅋㅋㅋㅋㅋㅋㅋㅋ
축하해주세요	🎉😊🎈
어...	🎉😊🎈
나보다심하다	.
이거아님	?
감사요	....
+ 4,5교시 입니다	.
얘들아 아미노산 서열 찾을 때 genbank들어가서 유전자길이 찾고 바로 쭉 아래로 내리면 염기서열 길게 쓰여 있는 거 바로 위에 나와!!	.
사진	??
보기 좋잖아요	ㅎㅎ
갠톡으로 보내시면 되잖음	??
이거개신기하네	?
그래서	?
사진	?
안졸려?	ㅋㅋㅋㅋㅋㅋ
원신하자	ㅠ
우리 방보다	?
예?	.
사진내놔라	🔪🔪🔪
@백은찬	🎂🔪🍰
나도알아	🙃
아 자꾸 이거 어디서 가지고 오는 겨	.
국어 수행평가 도서 선정해야해요!!	.
같이가~~~~~~	ㅋㅋㅋㅋㅋㅋㅋㅋㅋ
어디로가	?
쟤때문에	ㅠ
아파요	ㅋㅋㅋㅋㅋㅋㅋ
걍 저 ㅉ이 개빡침	🫣
왜 아무도 안 풀어주나요	..
아진심개졸리네	?
사라짐	ㅠㅠㅠㅠㅠ
내귀..	ㅋㅋ
원철이 열심히 한다	ㅋㅋㅋㅋㅋㅋㅋㅋㅋ
..?	.
그래서 안한 거임?	ㅋㅋㅋ
그렇대도 난 실망따윈 안해요	..
나랑 같이 갈사람	ㅠㅠㅠㅠ
..???	???
하..	ㅠㅠㅠㅠㅠㅠ
현타 개쎄게 온다..	..
..?	ㅋㅋㅋㅋㅋㅋㅋㅋ
뭐가 다르지	ㅋㅋㅋㅋㅋㅋ
사실이어서 반박 못한다	ㅋㅋ
지금 일어남	..
졸업만 하래	..
자자	ㅋㅋㅋ
생지노베	ㅠ
자는데 누가 노래를 틀어	ㅋㅋㅋㅋㅋㅋㅋㅋㅋ
공부함	.
성비 개에버	..
몇번이야	??
사진	?
공부해?	ㅋㅋㅋㅋㅋㅋㅋㅋㅋ
zzz	ㅋㅋㅋ
가현아 꺼지라고	ㅋ
어케더ㅣㅁ	ㅋㅋㅋㅋㅋㅋ
정환이 ㅎㅇ	ㅋㅋㅋㅋ
아맞다 나 필기 공유방 나간거 봄	?
등판	ㅋㅋㅋㅋㅋㅋㅋㅋㅋㅋㅋㅋㅋㅋ
ㅋㅋㅋㅋㅋ큐ㅜㅠ	ㅋㅋㅋㅋㅋㅋㅋㅋㅋㅋㅋㅋㅋㅋㅋㅋㅋ
쳐맞을라고	.
개재밌겠다	ㅋㅋㅋㅋㅋㅋㅋ
미친	ㅋㅋㅋㅋㅋㅋㅋㅋㅋㅋㅋㅋㅋㅋ
제발 지금해라 은찬아	..
시작을 안 함 아직	.....
전하가 표면에 잇으니까 이렇게 생각해도 되지않나	ㅋㅋㅋㅋ
