은세야|너네 시험범위어디임?|이번 6모 어땠어	이번 6모 어땠어	?
나 2점대 초반인듯|너는?|나랑 비슷하네	나랑 비슷하네	ㅠ
주말에는 집오는 거?|나는 선택|지금 6모 외우고 있음	지금 6모 외우고 있음	ㅋㅋ
누적범위?|우리돈데....|수학 중간에 몇등급이었어	수학 중간에 몇등급이었어	?
허...|난 역사...|수학 1컷이 73이였음	수학 1컷이 73이였음	ㅠㅠ
A가 65라던지|안녕하세요. 충남과학고 이은세, 정시은, 조수완입니다.|내일 방학해요 ^^	내일 방학해요 ^^	ㅠㅠ
불안하겠다|나 공수2가 44등인데|2등급이 43등 까지 였음	2등급이 43등 까지 였음	ㅠㅠ
난 등급만 받았어|반에서 몇등이야?|왤케 잘봤냐	왤케 잘봤냐	ㅠㅠ
반에서 몇등이야?|왤케 잘봤냐|우리는 1등이1.25임	우리는 1등이1.25임	ㅋㅋ
3모|도?|다시 보니까 2.34임	다시 보니까 2.34임	ㅋㅋ
영어 ㄹㅈㄷ노 어캐 8분을 늦게 끝냄..|ㅋㅎㅋ|zzz	zzz	ㅋㅋㅋ
그래|빅데이터|뜨개질 처럼	뜨개질 처럼	ㅋㅋ
ㅇㅋ|그사람 잘 가르침|아마도	아마도	...
파이썬 기초|압축 알고리즘|이런거	이런거	....
아니|저거 담임 부담임 대체 사진임|톡게시판 '투표': 반티	톡게시판 '투표': 반티	.
사진|톡게시판 '투표': 반티|쌤 사진은 초상권이니까 비슷한인믈로 대체	쌤 사진은 초상권이니까 비슷한인믈로 대체	.
잘못보냄|ㅅㄹ|내가보낸거아님	내가보낸거아님	ㅜㅜ
지원자 받고 투표 고고합시다|지원자 없습니까?|사진	사진	..
진지하게 나쁘지 않아.|아니미친|이거뭐냐	이거뭐냐	..
이거|은찬이|그...	그...	..
버스 자리 맡아줘|https://youtu.be/3MbekSgShtU?si=hR9vWyMHg8pzyfhr|괜찮은 영상이니 한번씩 보길바람	괜찮은 영상이니 한번씩 보길바람	.
공수통학2 범위시험 아는시분?|선생님이 오늘 주신 프린트|시험에 안나온답니다	시험에 안나온답니다	!!
오른쪽 하단에 2 8 붙은 거 봤는데 시간 없어서 못 누름...|생각보다 되게 많이 놓쳤네??|사진	사진	ㅋㅋㅋㅋ
오이ㅣㅣㅣㅣㅣㅣ|불당동!!|헉 은찬이 DNA 끊어졌다	헉 은찬이 DNA 끊어졌다	ㅠㅠㅠㅠㅠㅠㅠㅠㅠㅠㅠㅠㅠㅠㅠㅠ
에이 그럼 2만 4천원 보내야되잖아|아이고...|영준아 뒤에 숫자 뭐야?	영준아 뒤에 숫자 뭐야?	.
ㅇㅋ|가현이가|보냈어요	보냈어요	ㅋㅋㅋㅋㅋㅋ
너가 사오게.....?|내일올라구???????|사진	사진	💋💋💋💋💋
사진 16장|브이를 하시길래|진짜 왜그러는 거에요	진짜 왜그러는 거에요	.
@누나 인|스타아이다ㅣ|주세여	주세여	🥵
영어는 내일 피드백 하나요?|물리 양식 있으신분?|안들어가져요	안들어가져요	ㅠ
아니 이양반|과기설 단톡에 보내라고요|아니이건 너무 엽산데	아니이건 너무 엽산데	ㅋㅋㅋㅋㅋㅋㅋ
시험 시간표|ㄷㄷ|민규도	민규도	?
사진|우리학교에서 뭐가 필요하다 싶으면|지학실 아님 화학실로 가면 있음	지학실 아님 화학실로 가면 있음	ㅋㅋㅋㅋㅋㅋㅋㅋㅋㅋ
김문수지지자최한별..|이나경 생일이에요|축하해주세요	축하해주세요	🎉😊🎈
뭐이씨|수업 중간에 올렸다|어...	어...	🎉😊🎈
오늘 지학 수업하지?|감사요|나보다심하다	나보다심하다	.
ㄱㄷ|사진|이거아님	이거아님	?
너 시험볼때 그렇게 해라 꼭|개똑똑해|감사요	감사요	....
삭제된 메시지입니다.|그렇다고 하셨어,,|+ 4,5교시 입니다	+ 4,5교시 입니다	.
아안돼!!!!,,|내 물리시간...|얘들아 아미노산 서열 찾을 때 genbank들어가서 유전자길이 찾고 바로 쭉 아래로 내리면 염기서열 길게 쓰여 있는 거 바로 위에 나와!!	얘들아 아미노산 서열 찾을 때 genbank들어가서 유전자길이 찾고 바로 쭉 아래로 내리면 염기서열 길게 쓰여 있는 거 바로 위에 나와!!	.
정환이 개고트네|넌 인정이다|사진	사진	??
태건이만 보세요|#tribonacci|보기 좋잖아요	보기 좋잖아요	ㅎㅎ
ㅊㅊ|종원쌤에게 말하고 갔을거잖음|갠톡으로 보내시면 되잖음	갠톡으로 보내시면 되잖음	??
안전교육이랑 7시랑 다른건가?|안전교육은뭐암|이거개신기하네	이거개신기하네	?
ㄱㄷ|이모티콘|그래서	그래서	?
사진|4시간의 노력이 없어져버림|사진	사진	?
안자|이제 자려고|안졸려?	안졸려?	ㅋㅋㅋㅋㅋㅋ
참좋을것같아|했어요|원신하자	원신하자	ㅠ
기숙사??|방 보여줘|우리 방보다	우리 방보다	?
25cnsh수강번호|이거 정신적 충격이 있지 안을까|예?	예?	.
@백은찬 사진내놔|사진|사진내놔라	사진내놔라	🔪🔪🔪
사진|사진내놔라|@백은찬	@백은찬	🎂🔪🍰
사진|여기까지?|나도알아	나도알아	🙃
넘 멀어욤|재형이 소유인줄|아 자꾸 이거 어디서 가지고 오는 겨	아 자꾸 이거 어디서 가지고 오는 겨	.
오오오오오|1305 박범서 생명 알엔이 적어주세요!!|국어 수행평가 도서 선정해야해요!!	국어 수행평가 도서 선정해야해요!!	.
나도|우리학교왓엇어????|같이가~~~~~~	같이가~~~~~~	ㅋㅋㅋㅋㅋㅋㅋㅋㅋ
대정병원 맞은편|아 나한테 물어보는줄|어디로가	어디로가	?
롤켰는데|잠시 멈칫함|쟤때문에	쟤때문에	ㅠ
흐즈믈르그|팩트폭력|아파요	아파요	ㅋㅋㅋㅋㅋㅋㅋ
ㄱㄱㄱ|이새기는 진짜 죽인다|걍 저 ㅉ이 개빡침	걍 저 ㅉ이 개빡침	🫣
이런거 필터 써서 올려야하는데|사진|왜 아무도 안 풀어주나요	왜 아무도 안 풀어주나요	..
링크를 눌러 ★AI|channi★ 님을 브롤스타즈 친구로 추가하세요! https://link.brawlstars.com/invite/friend/kr?tag=LQ8LPLUG&token=ht6ny32g|링크를 눌러 AI | ZZANII 님을 브롤스타즈 친구로 추가하세요! https://link.brawlstars.com/invite/friend/kr?tag=29YRVVYQV&token=ht6ny32g|아진심개졸리네	아진심개졸리네	?
아니진심|앞머리가|사라짐	사라짐	ㅠㅠㅠㅠㅠ
크게|잘하는데?|내귀..	내귀..	ㅋㅋ
패드 놓고 갔다|레고|원철이 열심히 한다	원철이 열심히 한다	ㅋㅋㅋㅋㅋㅋㅋㅋㅋ
@수완|@정시은|..?	..?	.
찾았따|dk|그래서 안한 거임?	그래서 안한 거임?	ㅋㅋㅋ
@이은세 @정시은|오늘 물리 안 갈래|그렇대도 난 실망따윈 안해요	그렇대도 난 실망따윈 안해요	..
나랑 이거 갈사람|안간대|나랑 같이 갈사람	나랑 같이 갈사람	ㅠㅠㅠㅠ
8시간 끊었어요|공부하려고|..???	..???	???
엔탈피 하나가|미친놈이야|하..	하..	ㅠㅠㅠㅠㅠㅠ
나 진심 화학에 벽느끼는거 처음이야|수능2점을 왜 쳐 못푸는거야..|현타 개쎄게 온다..	현타 개쎄게 온다..	..
@정시은|할거야?|..?	..?	ㅋㅋㅋㅋㅋㅋㅋㅋ
왜여|난 똑같은데|뭐가 다르지	뭐가 다르지	ㅋㅋㅋㅋㅋㅋ
은찬이 얼굴보이면 안됨|와우|사실이어서 반박 못한다	사실이어서 반박 못한다	ㅋㅋ
이제 잘게|잘 자 얘들아|지금 일어남	지금 일어남	..
엄마가|나보고|졸업만 하래	졸업만 하래	..
던지자|자저|자자	자자	ㅋㅋㅋ
겨우 참는중|수학물리노베|생지노베	생지노베	ㅠ
예?|님은 왜 안자요;|자는데 누가 노래를 틀어	자는데 누가 노래를 틀어	ㅋㅋㅋㅋㅋㅋㅋㅋㅋ
333|4444|공부함	공부함	.
좀 비쌀텐데 방탈출|근데 진짜 누구 하나 없냐|성비 개에버	성비 개에버	..
메카피시|어디로갈까|몇번이야	몇번이야	??
심심햐|ㅋㅋㅋㅋㅋㅋㅋㅋ 아냐|사진	사진	?
놀았는데|5살짜리가놀자는데|공부해?	공부해?	ㅋㅋㅋㅋㅋㅋㅋㅋㅋ
ㄴㅇㅅ|어그 쨀까?...|zzz	zzz	ㅋㅋㅋ
가현이 씹년|내가6왜|가현아 꺼지라고	가현아 꺼지라고	ㅋ
가서|영업때려|어케더ㅣㅁ	어케더ㅣㅁ	ㅋㅋㅋㅋㅋㅋ
공부 안 함?|넌 진짜 레전드다|정환이 ㅎㅇ	정환이 ㅎㅇ	ㅋㅋㅋㅋ
피파 하러갈게|좀 이따 옴|아맞다 나 필기 공유방 나간거 봄	아맞다 나 필기 공유방 나간거 봄	?
@정시은|재형|등판	등판	ㅋㅋㅋㅋㅋㅋㅋㅋㅋㅋㅋㅋㅋㅋ
대재형이랑 아직 대화 중임?|캡쳐ㄱㄱ|ㅋㅋㅋㅋㅋ큐ㅜㅠ	ㅋㅋㅋㅋㅋ큐ㅜㅠ	ㅋㅋㅋㅋㅋㅋㅋㅋㅋㅋㅋㅋㅋㅋㅋㅋㅋ
..?|샵검색: #안면강타|쳐맞을라고	쳐맞을라고	.
시은이 ㄱㄱ라고 치고|우린 하지 말자|개재밌겠다	개재밌겠다	ㅋㅋㅋㅋㅋㅋㅋ
후폭풍이 두려워|아ㅜ머해|미친	미친	ㅋㅋㅋㅋㅋㅋㅋㅋㅋㅋㅋㅋㅋㅋ
괜찮나|또 이러고 학교가서 개난리 치지말고|제발 지금해라 은찬아	제발 지금해라 은찬아	..
이제|물리함|시작을 안 함 아직	시작을 안 함 아직	.....
사진|표면에 전하 있다고 써놨어 나는|전하가 표면에 잇으니까 이렇게 생각해도 되지않나	전하가 표면에 잇으니까 이렇게 생각해도 되지않나	ㅋㅋㅋㅋ
